#######################
#   #    #   /        #
#   #    +   ##  ######
#   #    #   #    #   #
#        #   #        #
##########   ##########
#   #    #   #        #
#   #    +   ##  ######
#  ###   #   /     #  #
#        #   #        #
##########   ##########
#        #   #        #
#   #    +   #####  ###
###### ###   +   #    #
#        #   #        #
########## --##########
         #>|<#         
         #===#         
         #####         
